1111111111111
10010000C0001
10E0011111001
1P00110000001
1111111111111
