1111111111111
10010000C0001
10E0011111001
1P00110CC0001
1111111111111
