111111111111111111
1001C000C00C0100E1
100010011000000101
101001100111010001
1P00110CC00C001101
111111111111111111
