11111111111111111111111111111
1001C00C0000010000001010000E1
1C00000001010T000000001000001
11TC0010C000000100110100T0001
10001000010000C101000C0000001
1P00C01001010001000C000000011
11111111111111111111111111111
