111111111111111111
1001C000C00CT100E1
10T00T011000000101
101001100111010001
1P00110CC00C000101
111111111111111111
